######################################################################|
|  -- --------------------------------------------------------------  |                                                                 
|  -- %%%%%%%%%%%   ---          %%%%%%%%%%%%%           %%%%%%%%%%-- |
|  --    |%|   |%|  ---          |%|       |%|      ---         |%|   |
|  --    |%|   |%|  ---          |%|       |%|      ---         |%|   |
|  --     %%%%%%%%  ---          %%%%%%%%%%%%%      ---         |%|   |
|  --                             ---------- -- -         %%%%%%%%%   |
|  --                                                                 |
|  --    %%%%%%%%%%%%%%           %%%%%%%%%%%%%%%%            %%%%%-- |
|  --       |%|       |%|           |%| ---------               |%|-  |
|  --       |%|       |%|           |%| -----------|%|          |%|-  |
|  --       |%|       |%|               -----------|%|          |%|-  |
|  --                    |%|- - %%%%%%%%%%%%%      |%|                |
|  --                                ----|%|    %%%%%%%%%%%           |
|  --                                ----|%|                          |
|  --   |%|      - - ----- --- - -  - - - - - - - - - - - - -  -      |
|  --   |%|                                                           |
|  --   |%|       -- --- - --  - |%|%%%%%%%%%%%%%%%%                  |
|  --   |%|                                                           |
|  --               - - - - - - - --- ---- - -  - - - - - - - - -     |
|  --                                                                 |
|  -- -----------------------------------------------------------     |
|     -----------------------------------------------------------     |                                                           
######################################################################|